package	proporty
hdf5r	data processing
Seurat	SRT analysis
dplyr	data processing
bigreadr	data processing
CARD	SRT analysis
plyr	data processing
gtools	data processing
SingleCellExperiment	SRT analysis
ggplot2	data processing
scatterpie	data processing
SPARK	SRT analysis
amap	data processing
viridis	plot processing
tidyr	data processing
reshape2	data processing
scales	data processing
SeuratDisk	SRT analysis
BASS	SRT analysis
scSorter	SRT analysis
monocle	SRT analysis
garnett	SRT analysis
org.Hs.eg.db	SRT analysis
org.Mm.eg.db	SRT analysis
glmGamPoi	data processing
SpatialPCA	SRT analysis
circlize	data processing
SpaTalk	SRT analysis
liana	SRT analysis
Giotto	SRT analysis
CellChat	SRT analysis
clusterProfiler	SRT analysis
ReactomePA	SRT analysis
DOSE	SRT analysis
tibble	data processing
Matrix	data processing
Slingshot	SRT analysis
tradeSeq	data processing
BiocParallel	data processing
stringr	data processing
ComplexHeatmap	plot processing
ggtree	plot processing
aplot	plot processing
patchwork	plot processing
